#                                                          #
#                                                          #
#                                                          #
#                                                          #
#                                                          #
#                                                          #
#                     ####                                 #
#                                                          #
#             #                                            #
#                                                          #
#                                                          #
#                                                          #
#                          #                               #
#                                                          #
############################################################
